###############################
#       #     #     #         #
# # ### # ### # ### # ##### ###
# #   # #   # # #   # #     # #
# # # # ### # # # ### # ### # #
#   # #   #   # #     #   # # #
### # ### ##### ####### ### # #
#   # #   #         # # #   # #
# ######### ####### # ### ### #
# #     #   #     # #   #   # #
# # ### # ### ### # ### # ### #
# #   #   #   #   #   # #     #
# ### # ### ### #### ## ##### #
#     #   #     #       #     #
###############################