##N#####
#######     󰯊####
#####󰯊 󰯊#######       ##
#                    #
#  ############       #
##        󰯊###       ##
####### ########    ##
# #### ##
#### ## #
## 󰜦# ######### #
##    ##### 󱔐   #
#  󰻝    #####󰯊  󱔐  #
##       󰖼 #### 󱔐   #
###󰯊     ####󱔐  #
##  ## ##  #
#########S#