
######
#N######   #
###  ### ####   ######
#           ###      #
###             ## ### ##
#       ###      # ##  ##
##       ##        ##   #
#        ####       ##   E
#         ##      ####   #
##        ####    ###   ##
#        ##    ###   #
##      #######  ##    #
#  ####### ###  ###
#####     ##
######