###############################
#   ##        ##              #
#   #####       ##               #
#                ###        #      #
######    #####      ####         #      #
##        ###      ###          #      #
#         ##      ###      #####      #
#        #####     ####      ###      #
##       ###      ###      ####       #
#        ###     ####      ###        #
#       ####      ###      ###         #
#     ####       ###       ##       #  #
#     ##       #####        ##       #  #
#    ###        ####          ###      ### #
#   ####       ###            ##      ### #
#  ###                      ##     ## #
# #########                    ###    ###  #
# ###   ###            ##      ##    ##  #
# ###     ####           #       ###   #### #
#          ###         #        ##    ####
#       #######       #        ##    #
#      ########### #     ###    #
###########     ###    #
  #   #####     #
  ##           ##
      #           #
          ##          #
           ############