##
###########
##󰯊 󰯊#### ### ##
W    ## #####  ##
#  ####    ### ##
#  ### #####    ##
#  ### ##󰯊#󰯊#    E#
#  ## #####    #
#  ###  ###    ###
#   #        ##
##      #  ###
##     #  ##
##        #
###󰯊######
###